w,w,w,w,w,w,w,w,w,w,w,w,w,w,w,w,w,w,w,w,w,w,w,w
w,w,w,w,w,w,w,w,w,w,w,w,w,w,w,w,w,w,w,w,w,w,w,w
w,w,w,w,w,w,w,w,w,w,w,w,w,w,w,w,w,w,w,w,w,w,w,w
w,w,w,w,w,w,w,w,w,w,w,w,w,w,w,w,w,w,w,w,w,w,w,w
w,w,w,w,w,w,w,w,w,w,w,w,w,w,w,w,w,w,w,w,w,w,w,w
w,w,w,w,w,w,w,w,f,f,f,f,f,f,f,w,w,w,w,w,w,w,w,w
w,w,w,w,w,w,w,w,f,f,f,f,f,f,f,w,w,w,w,w,w,w,w,w
w,w,w,w,w,w,w,w,f,f,f,f,f,f,f,w,w,w,w,w,w,w,w,w
w,w,w,w,w,w,w,w,f,f,f,f,f,f,f,w,w,w,w,w,w,w,w,w
w,w,w,w,w,w,w,w,f,f,f,f,f,f,f,w,w,w,w,w,w,w,w,w
w,w,w,w,w,w,w,w,w,w,f,f,w,w,w,w,w,w,w,w,w,w,w,w
w,w,w,w,w,w,w,w,w,w,f,f,w,w,w,w,w,w,w,w,w,w,w,w
w,w,w,w,w,w,w,w,w,w,f,f,f,f,f,f,f,f,w,w,w,w,w,w
w,w,w,w,w,w,w,w,w,w,f,f,f,f,f,f,f,f,w,w,w,w,w,w
w,w,w,w,w,w,w,w,w,w,f,f,f,f,f,f,f,f,w,w,w,w,w,w
w,w,w,w,w,w,w,w,w,w,w,w,w,w,w,f,f,f,w,w,w,w,w,w
w,w,w,w,w,w,w,w,w,w,w,w,w,w,w,f,f,f,w,w,w,w,w,w
w,w,w,w,w,w,w,w,w,w,w,w,w,w,w,f,f,f,w,w,w,w,w,w